name	degree
Alan d’Andrea	MD
Jon Aster	MD, PhD
Pratiti (Mimi) Bandopadhayay	MBBS, PhD
David Barbie	MD
Ethan Cerami	PhD
Benjamin Levine Ebert	MD, PhD
William Freed-Pastor	MD, PhD
Leena Gandhi	MD, PhD
Todd R. Golub	MD
Matthew L. Hemming	MD, PhD
Pasi A. Jänne	MD, PhD
Rinath Jeselsohn	MD
Sheheryar Kabraji	BM BCh
Keith Ligon	MD, PhD
Amanda Martinot PhD, MPH, DVM
Franziska Michor	PhD
Elizabeth Mittendorf	MD, PhD
David Pellman	MD
David A. Reardon	MD
Geoffrey Shapiro	 MD, PhD
Alex Spektor	MD, PhD
Sara M. Tolaney	MD, MPH
David M. Weinstock	MD
Patrick Y. Wen	MD
Kai W. Wucherpfennig	MD, PhD
Jean Zhao	PhD
